11111111111111111111111111111
100000C000000000000000000C001
100000P0000000000000000000011
1000000000000000000000000E111
11111111111111111111111111111